1. 脫塵齋早菊	人物,嘉義市,街道
2. 面山樓新桃	人物,嘉義市,街道
3. 冷紅室看雲	人物,嘉義市,街道
4. 遊北香湖即景	地景（山水）
北香湖懷古	地景（山水）
悶紅館聽雨	人物,嘉義市,街道
遊襟山即景	人物,嘉義市,地景（山水）
東園春禊	嘉義市,街道
祝壺仙偉像除幕暨幼稚園成立典禮	人物,嘉義市
送春之日陪亞南畫伯令夫人女公子及諸先生遊公園	人物,嘉義市
十字樓夜棋	人物,嘉義市
遊檨圃故址	人物,嘉義市,街道
玄風俱樂部成立感賦	嘉義市
琳琅閣春蘭	人物,嘉義市,街道
悼鸚鵡歌	動物,嘉義市
水雲亭賞奇石作歌贈主人百樓無涯賢昆仲	人物,嘉義市,街道
鬥雞	動物,嘉義市
蝶	動物,嘉義市
競馬會	動物,嘉義市
脫塵齋賞菊	人物,嘉義市,街道
金魚	動物,嘉義市
雙燕	動物,嘉義市
市聲	嘉義市,街道
龍蝦	動物,嘉義市
默園訪菊	人物,嘉義市,街道
夏日遊鷺夕園賦呈文龍君	人物,嘉義市,街道
虎	動物,嘉義市
鶴子	動物,嘉義市
題犬	動物,嘉義市
題雉	動物,嘉義市
率嘉義保甲婦女團襟山遠足	人物,嘉義市,街道
遊半天岩	地景（山水）
蘭潭泛月	嘉義市,地景（山水）
檜沼垂綸	嘉義市,地景（山水）
公園雨霽	嘉義市,地景（山水）
林場風清	嘉義市,地景（山水）
鷺橋跨浪	嘉義市,地景（山水）
橡苑聽鶯	嘉義市,地景（山水）
彌陀晨鐘	嘉義市,地景（山水）
康樂暮鼓	嘉義市,地景（山水）
遊蘭潭即景	嘉義市,地景（山水）
老蟬	動物,嘉義市
遊半天岩	地景（山水）
登太原山	嘉義市,地景（山水）
梅山賞梅	地景（山水）
遊壺仙花果園	人物,嘉義市,街道
諸羅演武廳故址	嘉義市,街道
米粉井	嘉義市,街道
祝嘉義彌陀寺修建落成典禮	嘉義市,街道